1111111111111111111111
1P00011110000000001111
11110000001111000000C1
1C00001100000001111111
11110000011C11000000C1
1000011001100001111111
1C00011001100000000CE1
1111111111111111111111